NO       ./path_to_the_north_texture
SO              ./path_to_the_south_texture
F   255,   192 ,   203
WE   ./path_to_the_west_texture
EA    ./path_to_the_east_texture

C 173 216 230

11111111111111111111111111111
10000000011100000000000011111
1011000001110010N000000111111
10010000000000000000000001111
11111111101100000111000000001
10000000001100000111101111111
11110111111100011100000000001
11110111111111011101010010001
11000000110101111100000010001
10000000000000001100000010001
10000000000000001101010010001
11000001110101011111011110001
11110111111101011100011010001
11111111111111111111111111111
